111111111111111
100222222222001
100222222222001
122222222222221
122222222222221
122222222222221
122222222222221
122222222222221
122222222222221
122222222222221
122222222222221
122222222222221
100222222222001
100222222222001
111111111111111
