111111111111111
110101010101011
100101010101011
100000000000011
100101010101011
100000000000011
100101010101011
100000000000011
110101010101011
100000000000011
110101010101011
100000000000011
110101010101011
111111111111111
111111111111111