11111111111111
11010101010101
10010101010101
10000000000001
10010101010101
10000000000001
10010101010101
10000000000001
11010101010101
10000000000001
11010101010101
10000000000001
11010101010101
11111111111111
