101010101010
001010101010
000000000000
001010101010
000000000000
001010101010
000000000000
101010101010
000000000000
101010101010
000000000000
101010101010
