111111111111111
100000000000001
101210101012101
102200000002201
101010101010101
100000000000001
101010101010101
100000000000001
101010101010101
100000000000001
101010101010101
100000000002201
101010101012101
100000000000001
111111111111111